ТОС		ТАС
ПРО^		ПРА
ТСЯ$		ЦА
ОО		АА
ОЙ^		ОЙ
ЛЯ		Л'А
НЯ		Н'А
ОМУ$		АМУ
РО^		РО
ОВ$		ОФ
АЯ$		АЙА
А		А
Б		Б
В		В
ГО		ВА
Г		Г
Д		Д
Е		'Э
Ж		Ж
З		З
И		И
Й$		Й
Й		Й
К		К
ЛЛ		Л
Л		Л
М		М
НН		Н
Н		Н
О^		А
О		О
П		П
Р		Р
СЧ		Щ
С		С
Т^		Т
ТЧ		Ч
ТС		Ц
Т		Т
У		У
Ф		Ф
Х		Х
Ц		Ц
ЧТ		ШТ
Ч		Ч
Ч^		Ч
Ш		Ш
Щ		Ш
Ь		'
Ы		Ы
Ъ		_
Э		Э
Ю		'У
Я		'А
